714,714,714,714,714,714,714,714,714,714,714,714,714,714,714,714,714,714,714,714,714,714,714,714,714,714,714,714,714,714,714,714,714,714,714,714,524,553,553,553,244,244,244,244,443,503,500,500,500,500,500,500,500,500,500,500,500
714,714,714,714,714,714,714,714,714,714,714,465,714,714,714,714,714,714,714,714,714,714,714,528,529,530,714,714,714,714,714,714,714,714,714,524,553,553,553,244,244,244,244,443,503,500,500,500,500,500,500,500,500,500,500,500,500
714,714,714,714,714,714,714,714,714,714,714,487,714,714,714,714,714,714,714,714,714,714,714,714,714,714,714,714,714,714,714,714,714,714,524,553,553,553,244,244,244,244,443,503,500,500,500,500,500,500,500,500,500,500,500,500,500
714,714,714,714,714,714,714,714,714,714,714,509,714,714,714,714,714,714,714,714,714,714,714,714,714,714,714,714,714,714,714,714,714,524,553,553,553,244,244,244,244,443,503,500,500,500,500,500,500,500,500,500,500,500,500,500,500
714,714,714,714,714,714,714,714,714,714,714,714,714,714,714,714,714,714,714,714,714,714,714,714,714,714,714,714,714,714,714,714,524,553,553,553,244,244,244,244,443,503,500,500,500,500,500,500,500,500,500,500,500,500,500,500,500
714,714,714,714,714,473,474,474,475,714,714,714,714,714,714,714,714,714,714,714,714,714,714,714,714,714,714,714,714,714,714,524,553,553,553,244,244,244,244,443,503,500,500,500,500,500,500,500,500,500,500,500,500,500,500,500,500
714,714,714,714,714,495,525,527,497,714,714,714,714,714,714,714,714,714,714,714,714,714,714,714,714,714,714,714,714,714,524,553,553,553,244,244,244,244,443,503,500,500,500,500,500,500,500,500,500,331,500,500,500,500,500,500,500
714,714,714,714,714,495,569,548,497,714,714,714,714,714,714,714,714,714,714,714,714,714,714,714,714,714,714,714,714,524,553,553,553,244,244,244,244,443,503,500,500,500,500,500,500,500,500,500,500,500,500,500,500,500,500,500,500
714,714,714,714,714,517,518,518,519,714,714,714,714,714,714,714,714,714,714,714,714,714,714,714,714,714,714,714,524,553,553,553,244,244,244,244,443,503,500,500,500,500,500,500,500,500,500,500,500,500,500,500,500,500,500,500,500
714,714,714,714,714,714,714,714,714,714,714,714,714,714,714,714,714,714,714,714,714,714,714,714,714,714,714,524,553,553,553,244,244,244,244,443,503,500,500,500,500,500,500,500,500,500,500,500,500,500,500,500,500,500,500,500,500
714,714,714,714,714,714,714,714,714,714,714,714,714,714,714,714,714,714,714,714,714,714,714,714,714,714,524,553,553,553,244,244,244,244,443,503,500,500,500,500,500,500,500,500,500,500,500,500,500,500,500,500,500,500,500,500,500
714,714,714,714,714,714,714,714,714,714,714,714,714,714,714,714,714,714,714,714,714,714,714,714,714,524,553,553,553,244,244,244,244,443,503,500,500,500,500,500,500,500,500,500,500,500,500,500,500,500,500,500,500,500,500,500,500
714,714,714,714,714,714,714,462,463,464,714,714,714,714,714,714,714,714,714,714,714,714,714,249,249,249,249,249,249,249,249,249,249,249,249,500,500,500,500,500,500,500,500,500,500,500,500,500,500,500,500,500,500,500,500,500,500
714,714,714,714,714,714,714,484,485,486,714,714,714,714,714,714,714,714,714,714,714,714,714,524,553,553,553,244,244,244,244,443,503,500,500,500,500,500,500,500,500,500,500,500,500,500,500,500,500,500,500,500,500,500,500,500,500
714,714,714,714,714,714,714,506,507,508,714,714,714,714,714,714,714,714,714,714,714,714,524,553,553,553,244,244,244,244,443,503,500,500,500,500,500,500,500,500,500,500,500,500,500,500,500,500,500,500,500,500,500,500,500,500,500
714,714,714,714,714,714,714,714,714,714,714,714,714,714,714,714,714,714,714,714,714,524,553,553,553,244,244,244,244,443,503,500,500,500,500,500,500,500,500,500,500,500,500,500,500,500,500,500,500,500,500,500,500,500,500,500,500
714,714,714,714,714,714,714,714,714,714,714,714,714,714,714,714,714,714,714,714,524,553,553,553,244,244,244,244,443,503,500,500,500,500,500,500,500,500,500,500,500,500,500,500,500,500,500,500,500,500,500,500,500,500,500,500,500
714,714,714,714,714,714,714,714,714,714,714,714,714,714,714,714,714,714,714,524,553,553,553,244,244,244,244,443,503,500,500,500,500,500,500,500,500,500,500,500,500,500,500,500,500,500,500,500,500,500,500,500,500,500,500,500,500
714,714,714,714,714,714,714,714,714,714,714,714,714,714,714,714,714,714,524,553,553,553,244,244,244,244,443,503,500,500,500,500,500,500,500,500,500,500,500,500,500,500,500,500,500,500,500,500,500,500,500,500,500,500,500,500,500
714,714,714,714,714,714,714,714,714,714,714,714,714,714,714,714,714,524,553,553,553,244,244,244,244,443,503,500,500,500,500,500,500,500,500,500,500,500,500,500,500,500,500,500,500,500,500,500,500,500,500,500,500,500,500,500,500
714,714,714,714,714,714,714,714,714,714,714,714,714,714,714,714,524,553,553,553,244,244,244,244,443,503,500,500,500,500,500,500,500,500,500,500,500,500,500,500,500,500,500,500,500,500,500,500,500,500,500,500,500,500,500,500,500
714,714,714,714,714,714,714,714,714,714,714,714,714,714,714,524,553,553,553,244,244,244,244,443,503,500,500,500,500,500,500,500,500,500,500,500,500,500,500,500,500,500,500,500,500,500,500,500,500,500,500,500,500,500,500,500,500
714,714,714,714,714,714,714,714,714,714,714,714,714,714,524,553,553,553,244,306,307,244,443,503,500,500,500,500,500,500,500,500,500,500,500,500,500,500,500,500,500,500,500,500,500,500,500,500,500,500,500,500,500,500,500,500,500
714,714,714,714,714,714,714,714,714,714,714,714,714,524,553,553,553,244,244,244,244,443,503,500,500,500,500,500,500,500,500,500,500,500,500,500,500,500,500,500,500,500,500,500,500,500,500,500,500,500,500,500,500,500,500,500,500
714,714,714,714,714,714,714,714,714,714,714,714,524,553,553,553,244,244,244,244,443,503,500,500,500,500,500,500,500,500,500,500,500,500,500,500,500,500,500,500,500,500,500,500,500,500,500,500,500,500,500,500,500,500,500,500,500
714,714,714,714,714,714,714,714,714,714,714,524,553,553,553,244,244,244,244,443,503,500,500,500,500,500,500,500,500,500,500,500,500,500,500,500,500,500,500,500,500,500,500,500,500,500,500,500,500,500,500,500,500,500,500,500,500
714,714,714,714,716,714,714,714,714,249,249,249,249,249,249,249,249,249,249,249,249,500,500,500,500,500,500,500,500,500,500,500,500,500,500,500,500,500,500,500,500,500,500,500,500,500,500,500,500,500,500,500,500,500,500,500,500
714,714,714,714,714,714,714,714,714,524,553,553,553,244,244,244,244,443,503,500,500,500,500,500,500,500,500,500,500,500,500,500,500,500,500,500,500,500,500,500,500,500,500,500,500,500,500,500,500,500,500,500,500,500,500,500,500
714,714,714,714,714,714,714,714,524,553,553,553,244,244,244,244,443,503,500,500,500,500,500,500,500,500,500,500,500,500,500,500,500,500,500,500,500,500,500,500,500,500,500,500,500,500,500,500,500,500,500,500,500,500,500,500,500
714,714,714,714,714,714,714,524,553,553,553,244,244,244,244,443,503,500,500,500,500,500,500,500,500,500,500,500,500,500,500,500,500,500,500,500,500,500,500,500,500,500,500,500,500,500,500,500,500,500,500,500,500,500,500,500,500
714,714,714,714,714,714,524,553,553,553,244,244,244,244,443,503,500,500,500,500,500,500,500,500,500,500,500,500,500,500,500,500,500,500,500,500,500,500,500,500,500,500,500,500,500,500,500,500,500,500,500,500,500,500,500,500,500
714,714,714,714,714,524,553,553,553,244,244,244,244,443,503,500,500,500,500,500,500,500,500,500,500,500,500,500,500,500,500,500,500,500,500,500,500,500,500,500,500,500,500,500,500,500,500,500,500,500,500,500,500,500,500,500,500
714,714,714,714,524,553,553,553,244,244,244,244,443,503,500,500,500,500,500,500,500,500,500,500,500,500,500,500,500,500,500,500,500,500,500,500,500,500,500,500,500,500,500,500,500,500,500,500,500,500,500,500,500,500,500,500,500
714,714,714,524,553,553,553,244,244,244,244,443,503,500,500,500,500,500,500,500,500,500,500,500,500,500,500,500,500,500,500,500,500,500,500,500,500,500,500,500,500,500,500,500,500,500,500,500,500,500,500,500,500,500,500,500,500
714,714,524,553,553,553,244,244,244,244,443,498,500,500,500,500,500,500,500,500,500,500,500,500,500,500,500,500,500,500,500,500,500,500,500,500,500,500,500,500,500,500,500,500,500,500,500,500,500,500,500,500,500,500,500,500,500
714,524,553,553,553,244,244,244,244,443,503,500,500,500,500,500,500,500,500,500,500,500,500,500,500,500,500,500,500,500,500,500,500,500,500,500,500,500,500,500,500,500,500,500,500,500,500,500,500,500,500,500,500,500,500,500,500
524,553,553,553,244,244,244,244,443,503,500,500,500,500,500,500,500,500,500,500,500,500,500,500,500,500,500,500,500,500,500,500,500,500,500,500,500,500,500,500,500,500,500,500,500,500,500,500,500,500,500,500,500,500,500,500,500
553,553,553,244,244,244,244,443,503,500,500,500,500,500,500,500,500,500,500,500,500,500,500,500,500,500,500,500,500,500,500,500,500,500,500,500,500,500,500,500,500,500,500,500,500,500,500,500,500,500,500,500,500,500,500,500,500
553,553,244,244,244,244,443,503,500,500,500,500,500,500,500,500,500,500,500,500,500,500,500,500,500,500,500,500,500,500,500,500,500,500,500,500,500,500,500,500,500,500,500,500,500,500,500,500,500,500,500,500,500,500,500,500,500
553,244,244,244,244,443,503,500,500,500,500,500,500,500,500,500,500,500,500,500,500,500,500,500,500,500,500,500,500,500,500,500,500,500,500,500,500,500,500,500,500,500,500,500,500,500,500,500,500,500,500,500,500,500,500,500,500
244,244,244,244,443,503,500,500,500,500,500,500,500,500,500,500,500,500,500,500,500,500,500,500,500,500,500,500,500,500,500,500,500,500,500,500,500,500,500,500,500,500,500,500,500,500,500,500,500,500,500,500,500,500,500,500,500
244,244,244,443,503,500,500,500,500,500,500,500,500,500,500,500,500,500,500,500,500,500,500,500,500,500,500,500,500,500,500,500,500,500,500,500,500,500,500,500,500,500,500,500,500,500,500,500,500,500,500,500,500,500,500,500,500
244,244,443,503,500,500,500,500,500,500,500,500,500,500,500,500,500,500,500,500,500,500,500,500,500,500,500,500,500,500,500,500,500,500,500,500,500,500,500,500,500,500,500,500,500,500,500,500,500,500,500,500,500,500,500,500,500
244,443,503,500,500,500,500,500,500,500,500,500,500,500,500,500,500,500,500,500,500,500,500,500,500,432,436,436,436,436,436,436,433,434,434,434,435,436,436,436,436,436,437,500,500,500,500,500,500,500,500,500,500,500,500,500,500
443,503,500,500,500,500,500,500,500,500,500,500,500,500,500,500,500,500,500,500,500,500,500,500,500,460,462,462,462,462,462,462,462,462,462,462,462,462,462,462,462,462,465,500,500,500,500,500,500,500,500,500,500,500,500,500,500
503,500,500,500,500,500,500,500,500,500,500,500,500,500,500,500,500,500,500,500,500,500,500,500,500,460,462,462,462,462,462,462,462,462,462,462,462,462,462,462,462,462,465,500,500,500,500,500,500,500,500,500,500,500,500,500,500
500,500,500,500,500,500,500,500,500,500,500,500,500,500,500,500,500,500,500,500,500,500,500,500,500,460,462,462,462,462,462,462,462,462,462,462,462,462,462,462,462,462,465,500,500,500,500,500,500,500,500,500,500,500,500,500,500
500,500,500,500,500,500,500,500,500,500,500,500,500,500,500,500,500,500,500,500,500,500,500,500,500,460,462,462,462,462,462,462,462,462,462,462,462,462,462,462,462,462,465,500,500,500,500,500,500,500,500,500,500,500,500,500,500
500,500,500,500,500,500,500,500,500,500,500,500,500,500,500,500,500,500,500,500,500,500,500,500,500,488,492,492,492,492,492,492,492,492,492,492,492,492,492,492,492,492,493,500,500,500,500,500,500,500,500,500,500,500,500,500,500
500,500,500,500,500,500,500,500,500,500,500,500,500,500,500,500,500,500,500,500,500,500,500,500,500,500,500,500,500,500,500,500,500,500,500,500,500,500,500,500,500,500,500,500,500,500,500,500,500,500,500,500,500,500,500,500,500
